


         ###############
         #     #       #
         #     #xxxxxxx#
         #     #       #
         #     #       #
         #     c       #
         ###c######o####
         #     #    x  #
         #xx xx#       #
         #     #    x  #
         ###############